1111111111
0000100001
1110101101
1100001001
1101110011
1101110111
1101000001
1101011111
1100000000
1111111111
